################################################################################
#S..#.........................#.....#.....#.........#...............#.......#.##
#.#.###########.###########.#.###.#.#.###.###.#####.#.#############.#.#.###.#.##
#.#...........#.#.#.......#.#.....#.#.#.#...#.#...#.#.#.....#...#...#.#...#.#.##
#.###########.#.#.#.#####.#.#######.#.#.###.#.#.#.#.#.###.#.#.#.#.###.###.#.#.##
#.#.........#.#...#.#.#...#...#.......#...#.#.#.#...#.#...#.#.#.#.#...#.#.#...##
#.#.#######.#.#####.#.#.#####.#########.###.###.###.#.#.###.#.#.#.#.###.#.###.##
#...#.....#.#.......#.#...#...#...#.......#.....#...#...#.#...#.#.#...#.#.#...##
#.#####.#.#.#.#######.###.#.###.#.###.###.#######.#######.#####.#.###.#.#.#.####
#.......#.#.#.#...#...#...#.....#...#...#.............#.......#.#...#.#.#.#...##
###########.#.#.#.#.#.#.###.#######.###.#############.#.###.###.#.###.#.#.###.##
#.........#.#.#.#.#.#.#.#.#.#.....#.#.#.........#...#.#.#.#.....#...#...#...#.##
#.#########.###.#.#.#.#.#.#.#####.#.#.#.#########.#.###.#.#######.#.###.###.####
#.....#.........#.#.#...#.#.#.....#.#...#.......#.#.....#...#...#.#.......#...##
#####.###########.#####.#.#.#.###.#.#####.#####.#.#######.#.#.#.#########.###.##
#.#...#.....#...#.....#.#.....#.#.#...#...#...#...#.......#.#.#.......#...#...##
#.#.###.###.#.#.#####.#.#######.#.###.#.###.#.#######.#.###.#.#######.#.###.####
#.#...#.#.#...#.#.....#.....#...#.#.#...#...#.......#.#...#.#.....#.#.#...#...##
#.###.#.#.#####.#.#########.#.#.#.#.#####.#######.#.#####.#.#####.#.#.#######.##
#...#...#.....#.#.#.#.....#.#.#.#.....#.#.#...#...#.......#.#...#.#.#.#...#...##
#.#.#####.###.#.#.#.#.###.#.#.#.#####.#.#.#.#.#.###########.###.#.#.#.#.#.#.#.##
#.#.#.....#.#.#.#.#.#...#...#.#.....#.#.....#.#.#...#.......#...#.#.....#...#.##
#.###.#####.#.#.#.#.###.#########.#.#.#.#######.#.#.#.#######.###.###########.##
#.#.........#.#.#.#...#.....#.....#.#.#.#.......#.#.#.........#...#...#.....#.##
#.#.#######.#.#.#.#.#######.#.#####.#.#.#.#######.#.#.#########.###.#.#.###.#.##
#.#...#...#.#.#...#.#.....#.#.....#.#.#.#...#.#...#...#.........#...#.....#.#.##
#.#.###.#.###.#####.#.#.#.#.###.#.###.#####.#.#.#######.#####.###.#########.#.##
#...#...#.........#...#.#.#...#.#.....#...#.#...#.....#.#.....#...#.....#...#.##
#####.###########.#####.#.###.#######.#.#.#.#####.###.#.#######.###.###.#.###.##
#...#.......#...........#.#.#.......#...#.#...#...#.....#...#...#.#.#.#...#...##
#.#.#######.#############.#.#######.#####.#.#.#.###.#####.#.#.###.#.#.#####.####
#.#.......#.......#.....#.....#.....#.....#.#.#.#...#...#.#.#.#...#.#...#...#.##
#.#######.#######.#.#########.#.#####.#######.#.#####.#.#.#.#.###.#.###.#.###.##
#.#...............#...........#.#.....#.......#.#.....#...#...#...#.#...#.#...##
#.###################.#########.#.#####.#.#####.#.#############.#.#.#.###.#.#.##
#.........#.........#...#...#...#.#.....#.#...#.#.#.........#...#.#.#...#.#.#.##
#.#######.#.#######.#####.#.#.###.#####.###.#.#.#.#.#######.###.###.#.#.#.###.##
#.#...#...#.#...#.#.......#.#...#.......#...#.#.....#...#...#...#...#.#.#.....##
#.###.#.###.#.#.#.#########.###.#.#######.###.#######.#.#.###.###.#####.#####.##
#...#.#...#...#.#.....#...#.#...#.#...#...#...#...#...#.#.....#...#.........#.##
###.#.###.#####.#.###.###.#.#.###.#.#.#.###.###.#.#.###.#####.#.#####.###.###.##
#.#...#.#.....#.#...#.#...#...#...#.#.#.#.#...#.#...#...#.....#.....#.#...#...##
#.###.#.###.###.###.#.#.#.#########.#.#.#.###.#.#####.#############.#.#####.####
#.........#.........#...#...........#...#.......#...................#........G##
################################################################################
