####################################################################################################
#S......#.................#...........#.....#.#...............#...........#...............#...#...##
#####.###.#########.#.#####.###.#.#####.#.#.#.#.#########.#####.#########.#.#########.#####.#.#.#.##
#.....#...#.......#.#.#.....#...#.#.....#.#.#.#...#.....#.......#.......#...#...#.....#.....#.#.#.##
#.###.#.#######.#.#.###.#####.#.###.#####.#.#.###.#.#############.#####.#####.#.#.###.#.#####.#.#.##
#.#.#.#...#.....#.#.#...#...#.#.#.......#.#.#...#.#...#...........#...#.#.....#...#...#...#.#...#.##
#.#.#.###.#.#.#####.#.###.#.#.###.#######.#.#.#.#.###.#.###.#######.#.#.#.#.#######.#####.#.#####.##
#.#...#...#.#.#.....#.....#.#...#...#.....#...#.#.#...#...#.#...#...#.#.#.#.#.....#.....#.....#...##
#.#####.###.###.###.#######.###.###.#.#####.#####.#.#####.#.#.#.#.###.#.#.###.###.###########.#.####
#.#.....#...#...#...#.....#.#.#.....#.#.....#...#.#.......#...#.#.#.#.#.#...#...#.....#.......#...##
#.#.#######.#.#####.#.###.#.#.#######.#.#####.#.#.#.###########.#.#.#.#####.###.#####.#.#########.##
#.#.........#.....#.#...#...#.....#.#.#.#...#.#...#...#.#...#...#.#...........#.#...#.#.....#...#.##
#.#########.#####.#.###.#####.#.#.#.#.###.#.#.#######.#.#.#.#.###.#######.#####.###.#.#####.#.###.##
#...#.........#...#.#...#...#.#.#...#.#...#.#.#.....#...#.#.#...#...#.....#...#.#...#.....#...#...##
#.###.#######.#.#####.###.#.#.#.#####.#.###.#.#.#.###.###.#.###.###.#.#####.#.#.#.#.###.#####.#.####
#.......#...#.#.....#.#...#.#.#.....#...#.#...#.#.#...#...#.....#...#...#...#.#.#.#.#.#...#...#...##
#########.#.#######.#.###.#.#.#####.#####.#####.###.###.#######.#.#######.###.#.#.#.#.###.#.#####.##
#.........#.#.......#.#...#.#...#.....#.......#.......#.#.......#.#.......#.#...#.#.....#...#.....##
#.#########.#.#####.#.#.###.#####.###.###.#####.#######.#.#######.#.#######.#####.#####.#####.###.##
#.#.......#...#...#.#...#.#.....#...#...#.....#.....#...#.#.....#.#...#.......#...#...#.#.....#.#.##
#.#.#####.#####.#.#.#####.#####.#.#.###.#.###.#.#####.###.#.###.#.###.#.#.###.#.#.#.#.###.#####.#.##
#.#.#...#...#...#...#...#.......#.#.#...#...#...#...#...#.#.#...#...#.#.#...#.#.#.#.#.....#...#...##
#.#.#.#.###.#.#########.#.#########.###.###.#####.#.###.#.#.###.#.#.#.#####.#.#.###.#######.###.####
#.#...#...#.#.#.........#.#.......#...#.#...#...#.#...#.#.#...#.#.#.#.#.....#.#.#...#.........#...##
#.#######.#.#.#.#######.#.#.###.#.#.#.#.#.###.#.#.###.#.#####.#.###.#.#.#####.#.#.###.#######.###.##
#.....#...#...#.#.......#.#...#.#.#.#.#.#.#...#...#...#.....#.#...#.#.#.#.......#.#...#.....#...#.##
#.###.#.#######.#########.#####.#.#.#.#.###.#######.#####.###.###.#.#.#.#########.#.###.#######.#.##
#...#.#.........#.........#.....#.#.#.#.....#.............#...#...#.....#.........#...#.......#...##
#.###.#.#########.#########.#####.###.#######.###########.#.###.#########.###########.#######.######
#.#...#.#.........#.....#...#.........#...#...#...#...#...#...#.#.........#.....#.#...#.....#.....##
#.#.###.#.###########.#.#.#############.###.###.#.#.#.#######.#.#.#########.###.#.#.###.###.#.###.##
#.#.#...#.....#...#...#.#.......#...............#.#.#.........#...#.#.......#.....#.....#.#...#...##
#.#.#########.#.#.#.###.#######.#.#################.###############.#.###.###############.#####.####
#.#.........#...#.#...#.........#.#.........#.......#...................#.#...................#.#.##
#.#######.#######.###.###########.#.#######.#.#########.#####.###########.#.#############.###.#.#.##
#.......#.......#...#.....#.....#...#.......#...#.....#.#...#...#.......#...#.....#.....#...#.#...##
#######.#####.#####.#.###.#.#########.#########.#.###.###.#.#####.#####.###.#.###.#.###.#.#.#####.##
#.....#.#...#.....#.#...#.#.........#.....#...#...#...#...#.......#...#...#...#...#.#...#.#...#...##
#.#.###.#.#####.#.#.#####.#######.#.#####.#.#.#####.#.#.#############.###.#####.###.#.#######.#.####
#.#.....#.....#.#.#.#.....#.....#.#.#...#.#.#.#...#.#.#...#.....#.......#.#.....#...#.........#.#.##
#.###########.#.###.#.#####.###.#.###.#.#.#.#.#.#.#.#.###.###.#.#.#####.#.###.###.#########.###.#.##
#.............#...#.#.#...#.#...#.....#.#...#.#.#.#.#.#.#...#.#...#...#.#...#.#.#...#.....#.#...#.##
#######.#########.#.#.#.#.#.#.#########.#####.###.#.#.#.###.#.#####.#.#.###.#.#.###.###.###.#.###.##
#.....#.#.......#.....#.#...#.....#.....#...#.....#.#.....#.#...#...#...#...#.....#...#...#.#...#.##
#.###.#.#.#####.#######.#.#######.#.###.###.#####.#.#######.###.###.#####.#####.#####.#.#.#.###.#.##
#.#.#...#.#...#.....#...#.#.....#.#...#.....#...#.#...........#...#.#...#.#...#.#...#.#.#.....#...##
#.#.#####.###.#####.#.#####.###.#.#.#.#######.#.#.###########.###.#.#.###.#.#.###.#.#.#######.###.##
#.#.....#...#.....#...#.....#...#.#.#.........#...#.........#.....#...#...#.#.....#.#.....#...#...##
#.#####.###.###.#.#.###.#####.###.#######.#######.#.#######.#########.#.#.#.#######.#.###.###.#.####
#.#.......#...#.#...#...#...#.#...#.....#.#.....#.#...#...#.........#.#.#.#.#.#.....#.#.#...#.#.#.##
#.#.#####.###.#.#####.###.#.###.###.###.#.#.###.#####.#.#.#########.###.###.#.#.#####.#.###.#.#.#.##
#...#.......#.#.....#...#.#.#...#...#...#.#.#...#.....#.#.........#...#.#...#.......#...#...#.#.#.##
#############.#########.###.#.###.###.###.#.#.###.#####.###.#####.###.#.#.#########.###.#.###.#.#.##
#...........#...#.....#...#...#...#.#...#.#.#.....#.....#...#...#...#...#.....#.....#.#.#.#.#.#.#.##
#.#########.###.#.###.###.#.#####.#.###.###.#.###########.###.#.#####.#######.#.#####.#.#.#.#.#.#.##
#...#...#.#...#.#.#.#.....#.#.....#...#.....#.#.....#...#.....#.......#.......#...#.#...#.#...#...##
###.#.#.#.###.#.#.#.#######.#.#####.#.###.#####.###.#.#.#########.#####.#########.#.#.###.#######.##
#...#.#.....#...#.....#...#...#.....#.....#.....#.#...#.#...#...#...#.#.#.........#.....#.......#.##
#.###.#####.###.#####.#.#.###########.#####.#####.#####.#.#.#.#.###.#.#.#.###################.#.#.##
#.#.....#.....#.#...#...#.#.....#...#.#...#.#...#.......#.#...#...#...#.#...#...#...........#.#.#.##
#.#.###.#######.###.#####.#.###.#.#.#.#.#.#.#.###.#######.#######.###.#.###.###.#.#.#######.#.#.#.##
#.#.#...#.....#.....#.....#.#.....#.#...#.#.#.....#...#...#.....#...#.#.#.#...#...#.......#...#.#.##
#.###.###.###.#####.#.#####.#######.#####.#.###.###.#.#.#.#.###.###.#.#.#.###.#.#########.#.#####.##
#...#.#...#.......#.#.....#.....#...#.....#...#.....#...#.#.#...#...#.#.#...#.#.......#...#.#...#.##
#.#.#.#.###.#####.#.#####.#####.#.###########.#####.#######.#.###.###.#.###.#.#######.#.#####.#.#.##
#.#.#...#...#.#...#.#...#...#...#...........#...#...#...#...#.#.#.#...#...#.........#.#.......#...##
###.#.###.###.#.###.#.#####.#.#############.#.#.#####.#.#.###.#.#.#####.#.#########.###.############
#...#.#...#.....#...#...#...#.#.....#.......#.#...#...#...#...#.#.....#.#...#.#...#...#.#...#.....##
#.#####.###.#####.#####.#.###.#.#.#.#.###########.#.#######.###.#####.#####.#.#.#.###.#.#.#.#####.##
#.#...#...#.#.#...#.....#...#.#.#.#.#.#.........#.......#...#.....#...#.....#...#...#.#...#...#...##
#.#.#.###.#.#.#.###.#######.#.#.#.###.#.#####.#.#########.###.###.#.###.#####.#####.#.#######.#.#.##
#...#...#.#...#.#...#.....#...#.#.....#.#...#.#...#.......#...#...#.....#.....#...#.#.#.........#.##
#######.#.###.#.#.###.###.#####.#######.###.#.###.#.#######.###.#########.#####.#.#.#.#.#########.##
#.......#...#.#.#.#...#.#...#...#.....#.....#...#.#.#.......#.#...#.....#...#.#.#...#.#.....#...#.##
#.#######.#.###.#.#.###.###.#.###.#####.#######.#.#.#####.#.#.###.#.#.#####.#.#.#####.#######.#.####
#.....#.#.#...#.#.#.#.....#.#.#.#.......#.......#...#...#.#.#.....#.#.#.......#.....#...#.....#...##
#.###.#.#.###.#.#.#.#.#####.#.#.#.#######.###########.#.###.#.#####.###.###########.###.#.#######.##
#.#.#.#.#.#.#...#.....#.....#.#.#.....#...#...#.......#.#...#.#.....#...#.........#...#...#.#.....##
#.#.#.#.#.#.###########.#####.#.#####.#.###.#.#.#.#####.#.###.#.#####.###.#######.#.#######.#.######
#...#.#.#.#...........#.#.....#...#...#...#.#...#...#.#.#.#.....#.....#.#.......#...#.....#.#.....##
#####.#.#.#.#.#######.#.#.#####.#.#.#####.#.#######.#.#.#.#######.#####.#######.#.###.#.#.#.#####.##
#.....#...#.#.#.........#.....#.#...#.....#.#.....#.#...#.#.....#...#.........#.#.#...#.#.....#.#.##
#.#####.#####.#.#############.#######.#####.#####.#.###.#.#.###.###.#######.#.#.#.#.###.#####.#.#.##
#.#...#.#.....#...#.....#...#.........#.#...#.....#...#.#.....#...#...#.....#.#.#.#.#.#...#.....#.##
#.#.###.#.#########.###.#.#.###########.#.###.#.#####.#.#######.#####.#.#####.#.###.#.###.#######.##
#.#.......#.......#...#...#.........#.#...#...#.#.....#.#.....#.....#.#...#...#.....#...#.#.....#.##
#.#.#######.#####.###.###########.#.#.#.#####.#.#.#####.#.###.###.#.#.###.#.#########.#.#.#.###.#.##
#.#.#.....#.....#.....#...#.....#.#...#.......#.#.#...#.#...#.....#.#.#...#.#.#...#...#.#.#...#.#.##
#.###.###.#####.#######.#.#.#####.###.###.#######.#.#.#.#.#.###.#####.#.###.#.#.#.#.###.#.###.#.#.##
#.#...#...#...#.#...#...#.#.....#...#.#...#.......#.#...#.#...#.#.....#...#.#...#.....#.#.....#...##
#.#.###.#.#.#.#.#.###.#.#.#####.###.###.###.#######.#########.###.#######.#.###########.############
#.....#.#.#.#...#.....#.#.#...#.#...#...#...#.....#.#.......#...#...#.....#.#...#.....#...........##
#.#####.#.#.#####.#####.#.#.#.#.#.###.###.###.#.###.#.#####.###.###.#.#.###.#.#.#.###.#.#########.##
#...#...#.#...#.......#.#.#.#...#.#...#.#.#...#.......#...........#.#.#...#...#.#.#...#...#...#...##
###.#.#######.#########.#.#.#####.#.###.#.#####.#########.#########.#####.#####.#.#.#####.#.#.#.####
#...#.#.....#...........#...#.....#...#.#.#...#.#.......#...#.....#.....#.#...#.#.#.#.....#.#...#.##
#.###.#.###.###############.#.#######.#.#.#.#.###.#####.#####.###.#####.#.#.###.#.#.###.###.#####.##
#...#.....#.................#...........#...#.........#.........#.........#.......#.....#........G##
####################################################################################################
####################################################################################################
