############
############
############
#..........G
#.#########.
#.#.......#.
#.#.#####.#.
#...#.....#.
###.#.#####.
S...#.......
############
############
############