#..........G
#.#########.
#.#.......#.
#.#.#####.#.
#...#.....#.
###.#.#####.
S...#.......