............................................................
............................................................
............................................................
S...........................................................
.########.##.....##.########....########.##....##.########..
....##....##.....##.##..........##.......###...##.##.....##.
....##....##.....##.##..........##.......####..##.##.....##.
....##....#########.######......######...##.##.##.##.....##.
....##....##.....##.##..........##.......##..####.##.....##.
....##....##.....##.##..........##.......##...###.##.....##.
....##....##.....##.########....########.##....##.########..
...........................................................G
............................................................
............................................................
............................................................