............................................................
..##.....##....###....########.########G....................
..###...###...##.##........##..##...........................
..####.####..##...##......##...##...........................
..##.###.##.##.....##....##....######.......................
..##.....##.#########...##.....##...........................
..##.....##.##.....##..##......##...........................
..##.....##.##.....##.########.########.....................
............................................................
...######...#######..##.......##.....##.########.########...
..##....##.##.....##.##.......##.....##.##.......##.....##..
..##.......##.....##.##.......##.....##.##.......##.....##..
...######..##.....##.##.......##.....##.######...########...
........##.##.....##.##........##...##..##.......##...##....
..#S....##.##.....##.##.........##.##...##.......##....##...
...######...#######..########....###....########.##.....##..
............................................................
