##############################
#S......#.......#.......#...##
#.#.#####.####.##.###.#.#.#.##
#.#.......#.#.....#.#.#...#.##
###.#.#####.#.#####.#.##.#####
#...#.......#...#...#.......##
#.#.#.#.#######.#.#####.###.##
#.#.#.#.#.....#.#.....#...#.##
#.###.#.#.###.#.###.#.#####.##
#.....#.#.#.#.#...#.#.#...#.##
#.#####...#.#.###.#.#.#.#.#.##
#...#...#...#.....#.#...#...##
###.#.#.###.###.###.#######.##
#...#.#.#...#...#.#...#.....##
#.###.#...###.#.#.###.########
#...#.#.#.....#.....#.......##
###.#.#.########.##.#######.##
#...#.#...........#.....#.#.##
#.###.#####.#####.#.###.#.#.##
#.#...#...#.#...#.....#...#.##
#...###.#.#.#.#.#.#######.#.##
#.#.#...#.....#.#.#...#...#.##
#.###.###.#.#####.#.#.#.###.##
#...#...#.#.#...#...#.....#.##
###.###.#.###.#...#######.#.##
#.#...#.#.....#.#.#...#...#.##
#.###.#.###.###.###.#.#####.##
#.......#...........#......G##
##############################
##############################
