##################################################
#S..........#...........#.......#...#.........#.##
#.###.#####.#.#.#######.#.###.###.#.#.###.###.#.##
#.#...#...#.#.#...#...#.#.#.#.....#...#...#.....##
#.#.#.#.#.#.#.###.#.#.###.#.########.##.##########
#.#.#.#.#.#.#.#.#.#.#.....#.....#.....#.........##
#.#.###.#.###.#.#.#.#####.###.#.#.###.###.#.###.##
#.#.....#...#.#.#...#.......#.#...#.......#.....##
#.#########.#.#.#####.#####.#.#####.#######.###.##
#.......#.#.#.......#...#.#.#.#...#.#.......#...##
#######.#...#######.###.#.#.###.#.#.#.#######.####
#.#...#.#.#.....#.#.....#...#...#.#.........#...##
#.#.#.#.#.#.###.#.#######.###.###.#.###.###.######
#...#.#.....#.#...#.....#.#.....#...#.....#.....##
#.###.###.#.#.###.#.###.#.#####.###.#.###.#####.##
#...#...#.#.#.......#...#.......#.#.#.#.#.#.....##
###.#.###.#.#########.###########.#.#.#.#.#.######
#.....#...#.......#...#.....#...#...........#...##
#.#.###.#####.###.###.#.###.#.#.#.###.#.#.###.#.##
#.#.#...#.....#.#...#.#.#.#...#.#.#.#.#.#.#...#.##
#.###.###.#.#.#.###.###.#.#####.#.#.#.#.#.#.######
#.#...#...#.#.....#.....#.....#...#.#.#...#...#.##
#.#.###.###.#####.#######.#.#######.#.#######.#.##
#.#.#.....#.#.#...#...#.#.#.........#.........#.##
#.#.###.###...#.###.#.#.#.###.#####.###########.##
#.#.....#...#.#.#...#.#...#...#...#.....#...#...##
#.#####.#.###.#.#.###.#####.###.#######.#.#.#.#.##
#.........#.......#.........#.............#...#G##
##################################################
##################################################
