###############
#S....#.....#.#
#.#.#.#.###.#.#
#.#.#.#...#...#
#.#.#.###.###.#
#.#.#.#...#...#
#.#.#.#.###.###
#.#.#...#.....#
#.#.#########.#
#.#.......#...#
#.#######.#.###
#.....#...#...#
#####.#.#####.#
#.....#...#..G#
###############
