##################################################
#S....................#.#.........#.............##
#.###################.#.#.#.#######.#########.#.##
#.#...............#...#.#.#.....#...#.......#.#.##
#.#.#############.#.###.#.#####.#.###.#####.#.####
#.#.....#.......#.#.#.#...#...#.#.#...#.....#...##
#.#####.#####.###.#.#.#.###.###.#.#.###.#######.##
#.#...#...#...#...#.#.......#...#.#...#.....#...##
#.#.#.#####.###.###.#######.#.#.#.###.###.###.#.##
#.#.#.....#.....#.......#...#.#.#...#...#.#...#.##
#.#.#.#####.#########.#.#.###.#.###.###.#.#.###.##
#.#.#.#...#.........#.#.#.#...#...#...#.#.#.#.#.##
#.#.###.#.#########.###.#.#.#####.###.#.###.#.#.##
#.#.....#.........#...#.#.#...#.#.#...#.#...#...##
#.#######.#######.###.#.#.###.#.#.#.###.#.###.####
#.......#.....#...#.#...#.#.#.#...#.#...#.#.#...##
#######.#######.#.#.#####.#.#.#####.#.###.#.###.##
#.#.....#.......#...#...#...#...#.....#...#.....##
#.#.#####.#########.#.#.#.#####.#.#####.##########
#.#.#.....#.#.....#.#.#.#.#...#.#.#.#...#.......##
#.#.#.#####.#.#.###.#.#.#.#.#.#.#.#.#.###.#####.##
#...#...#.....#.....#.#.#.#.#...#.#.#.#...#...#.##
#.###.#.#.###########.#.#.#.###.#.#.#.#.###.#.#.##
#...#.#.#.....#...#...#.#.#...#.#.#.#.......#.#.##
###.###.#####.#.###.#.###.###.#.#.#.#########.#.##
#.#.....#...#.#...#.#...#.#...#.#.#...#.....#.#.##
#.#######.#.#.###.#.###.#.#.###.#.###.#.###.#.#.##
#.........#.#...#.#...#.#.#...#.#.#...#.#.#.#.#.##
#.###.#########.#.###.#.#.###.###.#.#.#.#.#.###.##
#.#...#.........#...#.#.#.#.#.......#.#.#.#...#.##
#.#.###.#########.###.#.#.#.###########.#.###.#.##
#.#.#...#.......#.....#.....#.....#.....#...#...##
#.###.###.###.#.#############.###.#.#######.###.##
#...#.#.....#.#.#.......#...#.#.....#.........#.##
###.#.#######.#.#.#####.#.#.#.#######.#######.#.##
#...#.........#...#.#...#.#.#.....#.........#.#.##
#.#.###############.#.###.#.#####.#########.###.##
#.#.#.............#.#.#...#.....#.........#.....##
#.#.#.#####.#####.#.#.#.#######.#.#####.#.#.######
#.#.#.....#...#.....#...#.......#.#...#.#.#.#...##
#.#######.###.#####.#####.#######.#.#.###.#.#.####
#.......#.#.#.....#...#...#.......#.#...#.#.#...##
#.#####.#.#.#####.###.#.###.#####.#.###.#.#.###.##
#.#...#...#.....#...#.#.#...#...#.#.#.#.#.#.....##
#.#.#.#####.###.###.#.#.#####.#.###.#.#.#.#####.##
#.#.#...#...#.#...#.#.#...#...#.....#.#...#...#.##
#.#.###.#.###.###.#.#####.#.#########.#####.#.#.##
#...#.....#.......#.........#...............#..G##
##################################################
##################################################
