S##############
#.......#.....#
#.#####.#.#.###
#...#.#...#...#
###.#.#######.#
#.....#.#.....#
#######.#.#####
#.......#.....#
#.###########.#
#...#.......#.#
###.#.#.###.#.#
#...#.#...#...#
#.#######.###.#
#.........#...#
##############G
