##############################
#S#...#.......#.............##
#.#.#.#.#######.###########.##
#...#...#.......#.........#.##
#.#########.#.#####.###.###.##
#.#.......#.#.#.....#.#.#...##
#.#.#.###.###.#.#.###.#.#.####
#.#.#...#.....#.#.#.....#...##
#.#####.#########.#########.##
#.......#.......#.#...#.....##
#############.#.#.#.#.#.######
#.........#...#.#.#.#.#...#.##
#.#######.#.###.#.#.#.###.#.##
#.#.....#.#...#...#.#...#.#.##
#.#.###.#.###.#####.###.#.#.##
#...#.#.#.#...#.....#.#.#.#.##
#.###.#.#.#.#.#.#####.#.#.#.##
#.#...#.#...#.#...#...#.#...##
#.#.#.#.###.#####.###.#.###.##
#...#.#.#...#...#.....#.#...##
###.###.#####.#.#####.#.#.####
#.#.#...#.....#...#...#...#.##
#.#.#.###.#####.#.#.#######.##
#.#.#...#...#...#.#.#.......##
#.#.###.###.#.###.#.#.#.###.##
#...#.#...#.#...#.#.#.#.#...##
#.###.###.#.###.###.###.#.####
#.......#.....#.........#..G##
##############################
##############################
