S#...#...#
.#.#.#.#.#
.#.#.#.#.#
.#.#.#.#.#
.#.#.#.#.#
.#.#.#.#.#
.#.#.#.#.#
.#.#.#.#.#
.#.#.#.#.#
...#...#.G
