##############################
#S#...............#...#.....##
#.#.###########.#.#.#.#.#.####
#...#.....#.....#.#.#...#...##
#.#######.#.#####.#.#######.##
#...#.....#.#.....#.#.......##
###.#.###.#.###.#####.#####.##
#.#.#.#...#...#.#...#.#.....##
#.#.#.#######.#.#.#.#.#.######
#.#.#.......#.#...#...#.....##
#.#.#####.###.###.#########.##
#.#...#...#...#.#.#...#.....##
#.###.#.#.#.###.#.###.#####.##
#...#.#.#.#...#...#.#.#...#.##
#.###.#.#.###.###.#.#.#.#.####
#.....#.#.#.#...#...#...#...##
#.#####.#.#.###.##############
#.......#.....#...........#G##
##############################
##############################
